Lead Back-end Engineer	Manager
Professor of Iron Metallurgy	Other
Product and Business Development Manager (MBA Intern)	Manager
Co-Founder and Initiator	C-Suite
Recruiter & CEO/CTO	C-Suite
Brand Manager, Product Development	Manager
Chief Financial Officer and Executive Vice President	C-Suite
Manager - Consulting, Product Manager - Performance Reporting	Manager
Product Design & Marketing Guy	Other
IT Manager and Tech Director	Manager
HR Roles	Other
Vice President and General Manager of the Consumer Products and the Performance Materials	VP
GM - Southwest Denver (Price Club)	Other
Team Lead, DART Search	Manager
Vice President of Scientific and Medical Affairs	VP
Financial & Controllership Positions	Other
Software Development Engineer, Mobile	Other
SVP, Core Laboratory Diagnostics, Commercial Operations	VP
Senior Vice President & Chief Knowledge Officer	VP
Senior Segment Marketing Manager	Manager
Medical Assistance Supervisor	Other
Co-founder; Chief Merchandising Officer	C-Suite
Instrument Division Chief	C-Suite
Director of Engineering & Site Manager	Director
Real Estate Investment	Other
Vice President Quality, Learning & Development	VP
VP Emerging Technology Partnerships	VP
Founder & Country Coordinator for India	C-Suite
Chief of AI Dataset	C-Suite
Senior Offering Manager	Manager
Global Client Director	Director
Learning Designer, CEO	C-Suite
General Manager - Fintech	Manager
Business Support Admin	Other
COO, CFO & Director-Level Consultant	C-Suite
Financials & Tactics	Other
Sr. Director Sales- Development & Analytical Solutions	Director
Attraction and development executive and area manager	Manager
Associate Director, CoMotion Labs	Director
Director, Clinical Neuroscience	Director
Head of Media & Solutions department, Partner	Director
Media Services Manager	Manager
Freelance SMM-manager	Manager
Executive Vice-President Depositors, Strategy and Chief Operations Officer	VP
Member of the Board of Directors of Technology Committee	C-Suite
Founder / Technology	C-Suite
MD, Software & Services	Other
Director of Accounting and FINOP	Director
Technical Leadership Associate	Other
Head - Performance Engineering	Director
CEO - Commercialisation	C-Suite
Head of Security & Compliance	Director
Director of Product, Marketing, and New Business	Director
Staff Cloud Solutions Architect	Other
Director Of Facilities	Director
SVP & Director - R&D	Director
Supervisor of External Research Institutes & Head of the Industrial Galenics Laboratories	Director
President & Director of Sales	Director
Chief Legal Officer, General Counsel, and Corporate Secretary	C-Suite
Director, Product & Creative	Director
Manager Strategy - Engineering & Geospatial	Manager
Chairman, Technical Council	C-Suite
IT Research Analyst	Other
Global Health Consultant	Other
Managing Partner, ZMT Ventures	C-Suite
VP-Head of IT Security	Director
Board Member and Membership Chair	C-Suite
Engineering Manager, Principal Data Scientist	Manager
Product Manager (MJML) at Mailjet	Manager
Vice President of Technology - Platform Development	VP
DSW, LMSW, LMHC, DAPA, CASAC, ICDAC, CAC - Chief Compliance Officer - Director of Utilization Review	C-Suite
SVP, Strategy & Analysis	VP
Co-Founder, Brand Manager	C-Suite
Chair of the Technology Committee of the EAES - Member of the Executive Board	C-Suite
General Manager, New Initiatives	Manager
VP & Engineering	VP
Senior Consulting Accountant	Other
Senior VP of Client Services	VP
Founder & Chief Square	C-Suite
Expert UX	Other
Executive Director, Global Marketing	Director
Head of Private Equity Research	Director
Professor in Dept. of Electrical Engineering and Computer Science	Other
Regional Director a.i. - West Asia	Director
Post-doctoral Fellow	Other
CIO and Partner	C-Suite
BDM - Melbourne	Other
Database Manager	Manager
Vice-president of finance and information technology	VP
Principal Scientist / Senior Group Leader Diagnostic Development	Other
President - Commercial Banking	Director
China VP of Media & Marketing	VP
Director of Global Manufacturing	Director
Co-Founder & Program Directo	C-Suite
Head of Marketing & Direct to Consumer Business	Director
Director of Program , Content and Coaching MonacoTech	Director
Team Member - Engineering	Other
Director Production Operations - Disney Online	Director
Head of Member Services	Director
Variety of Finance Positions	Other
Head of delivery	Director
Account Manager, France	Manager
Vice President of Health Policy & Industry Relations	VP
Former Deputy Secretary	Other
Developer Database Applications - New Jersey	Other
Alumni Advisory Committee Board Member	C-Suite
Chairman of the Executive Committee for Research	C-Suite
Group Product Development & Portfolios Manager	Manager
Co-Founder, Lead developer	C-Suite
Executive Forum Member	C-Suite
Financial Trainee	Other
Advisory Board for Institute for Urban Research	Other
Head of Design at Deputy	Director
Program Officer in Research and Policy	Other
Independent Manufacturing & Business Development Contractor PowerOasis Ltd	Other
Direct Marketing Team Leader	Manager
Head of Installtion & Design - Public Art	Director
VP, Business Development & Corporate Accounts	VP
Credit Analysis Intern	Other
Head-Technology	Director
Chief Operating Officer & Clinical Director	C-Suite
Finance positions - UK	Other
Branch Accountant	Other
Manager Portal Technique	Manager
CTO Web Dev	C-Suite
General Manager Cyber & Corporate Security	Manager
Chairman of the Board of Directors of BP Zhejiang Petroleum Sales Co. Ltd.	C-Suite
Executive Vice-President, Chief Marketing Officer, and Chief Strategy Officer	C-Suite
Managing Director, Austria	Director
Director of Home Entertainment	Director
Chief Strategic Officer and Founder	C-Suite
Management Team	Other
EVP Individual Banking	VP
Associate Dean, School of Business	Other
Professor Emeritus, Department of Physics	Other
COO & SVP	VP
Product Management, Alexa	Manager
Professional Development	Other
Vice Chairman of the Board, Unilever NV	C-Suite
Senior Manager, Facebook Marketing	Manager
Co-Founder & VP Engineering Data	C-Suite
Executive Chairman of the Board and Co-Founder	C-Suite
Chairman RJ Corp	C-Suite
Newbuild Manager	Manager
Managing Principal & Co-Founder	C-Suite
Sales Director, Emerging Markets	Director
CTO and EVP of Product Development	VP
Program Advisory Board Member	C-Suite
Director of CfA Institute	Director
Chief Mindfulness Officer	C-Suite
PROCUREMENT and ACCOUNT MANAGER	Manager
Vice President of Risk, Safety & Transportation	VP
Head of Global Partnering	Director
Vice President, Application Sales	VP
Contract Department Director	Director
Applications Programmer & System Administrator	Other
Vice President of Oracle E-Business Suite Solutions	VP
CEO of UNC Health Care and dean of the UNC School of Medicine	C-Suite
Founder, CEO & Managing Director	C-Suite
Digital Lead - Brand Management	Manager
Group General Manager of Business Development	Manager
General Manager and Chief Revenue Officer	Manager
Head of Security Technologies Unit	Director
Visiting Professor in Software Engineering	Other
Vice President Digital Product Design	VP
Managing Director Israel and VP Customer Success	Director
Co-Founder, CMO, Director of E-Commerce	C-Suite
Director, Performance Marketing	Director
VP, GM Customer Contact BU	VP
Owner of Spectrum Consulting Group	Other
Director, Technology Commercialization	Director
Co-Founder&Chief Medical Officer	C-Suite
Co-Founder & Director of Technical Product Management & Delivery	C-Suite
Chief Product and Chief Operating Officer	C-Suite
Field Service and Development Specialist	Other
Head, Technology Development	Director
Co-founder: Product Management	C-Suite
Senior Vice President and Chief Financial Officer Miami Children's Hospital Health System	VP
Accounting Manager for Facts & Comparisons	Manager
CEO at red-stars.com data AG	C-Suite
CFO & CO-FOUNDER	C-Suite
Associate, Healthcare Investment Banking	Other
HR & Office Manager	Manager
Executive Vice President and head of Planning, Development, and Transportation	VP
Instructor for Real Estate	Other
Honorary Fellow	Other
Co-founder and chairman of the board	C-Suite
Director, Business Development & Intelligence	Director
Head of Network Solution Architecture	Director
Head of Engineering UK	Director
Free	Other
Investor, Ventures	Other
CEO Swfte (acquired)	C-Suite
Program Officer for Learning Health System Initiatives,	Other
Director / Project Manager / Support Architect & Engineer	Director
Chairman (co-founder)	C-Suite
Developer, Designer	Other
Software R&D Intern	Other
Vice President Business Development & Marketing	VP
Founding Investor & Founding Chairman	Other
Director - Media Services	Director
Commercial Operations Manager/Salesforce Administrator	Manager
Distinguished Engineer and SVP	VP
National Sales Trainer	Other
Partner and Americas FinTech leader	Manager
Business Process Automation Engineer	Other
advisor and Teacher	Other
Comercial Director	Director
General Counsel EMEA APAC	Other
Head of Accounting and Human Resources	Director
Developer / Back-End Architect	Other
Principal Engineer	Other
Manager for IT-Communication and Social Networks	Manager
Senior Mobile Analyst	Other
Sales & Market Development - several roles	Other
Technical Lead & Product Manager	Manager
Chairman And Managing Director	C-Suite
CCO and Deputy General Counsel	C-Suite
Partner in Charge, Government Services	Other
Senior Cyber Analyst	Other
Managing Partner, Andreessen Horowitz	Manager
Studio Owner	Other
Senior Director, Customer Success - Global Strategy and Operations	Director
Principal Architect, Network Technologies	Other
Director, Systems and Quality Engineering	Director
Head of Marketing, Canada	Director
Internet Product Assistant	Other
Business Development, Corporate Marketing & Investor Relations	Other
GM - Organized Tour Department	Other
Founder and Corporate Attorney	C-Suite
CMO Germany	C-Suite
Chief Scientific Officer (Aberdeen)	C-Suite
Vice President and General Manager - Maryland/Delaware Region	VP
Vice-President of Project and Portfolio Management	VP
North American Liaison	Other
Head of Strategic Analysis	Director
Senior Growth Marketing Manager	Manager
Controller & Resident Bohemian	Other
Worldwide Tech Leader	Manager
Talent Management	Other
Senior Account Executive, Automotive	Other
Regional Director (UA)	Director
Lead Portfolio Manager	Manager
Board non exec	C-Suite
Head - Product Management	Director
Clinical trial lead	Manager
SVP Real Estate, Store Design & Construction	VP
VP User Growth	VP
Co Founder , CEO & Chairman	C-Suite
Senior Vice President, Entertainment Development	VP
Chief Data Scientist, UBS Asset Management	C-Suite
Lead Wiki Manager	Manager
Global Expansion Lead	Manager
Co-Founder, Director, Interim CEO	C-Suite
Founding Partner & CMO/COO	C-Suite
Vice President of Wireless Engineering 	VP
Editor - Jersey City Magazine	Other
Chief Architect, EBG Nordic	Director
Marketing Science Measurement Partner	Other
VP, Mobile and Communications Group General Manager, Quality, Certification, Tools & Validation	VP
Trustee of The board of Directors	C-Suite
Sr. Data Team Lead | Artificial Intelligence	Manager
Vice President and General Manager of ASIC Product Line	VP
CEO, President and CFO	C-Suite
Product Data Lifecycle Business Analyst	Other
Board of Trustees of the Institute for Public Relations, Seminar Committee and Board Member	C-Suite
Associate Professor of Computer Science and Engineering	Other
Delivery & Procurement Director	Director
President, National Accounts Marketing	Director
Co-Chair, Tech Startup Committee	C-Suite
Board of Directors - Elbit Ultrasound Ltd. and Elbit Medical Holdings Ltd.	Director
2016 Cohort Member	Other
CTO, Innovation and Board Member	C-Suite
Head - European Operations	Director
Investor relations and operations manager	Manager
Vice President of Client Delivery Services	VP
Tech consultant	Other
College Music Marketing Intern	Other
GM USA	Other
Full-Stack Ruby Developer	Other
Director of Venture Investments	Director
Editor - Multimedia Innovations	Other
Executive Vice President, Product Management	VP
Director, Enterprise Digital Platform	Director
Senior Vice President of the Data ONTAP Group	VP
Designer, Developer, & Visual Storyteller	Other
Vice President of Marketing for the Cardiac and Monitoring Systems Business Unit	VP
Vice President, North America Sales and Operations	VP
Software Development & Architecture	Other
Director of Data Analysis	Director
Director Of Manufacturing, And Co-Founder	C-Suite
BrandLab Evangelist, North and Central Europe	C-Suite
EVP, Professional Services	VP
SVP & Head of Global Clinical Development	VP
General Manager of Video and Complex TV	Manager
Partener	Other
Portfolio Management	Manager
Clinton-Haiti Action Network, Interim Head	Director
Retail & Restaurant Director	Director
Software Test Lead	Manager
AVP, AT&T Cybersecurity Solutions	Other
S.E.O Assistant	Other
Company Secretary and General Counsel	Other
Executive Sponsor	Other
Customer Service	Other
Senior Manager Consumer Products & Services, Vodafone Group	Manager
Ecosystem Development Manager	Manager
Senior Product Manager - Visualization and Analysis at Splunk	Manager
SIEM Security Engineer	Other
Head of Connected Services, Digital and Mobility	Director
CCO & Board Member	C-Suite
VP of R&D/Assay Development	VP
EVP, Memory & Imaging Div.	VP
Commercial Category Lead	Manager
VP, Cloud & Operating System Infrastructure	VP
Chief Wrench	Other
Human Capital Consultant	Other
VP, Product & Marketing, TSYS Healthcare	VP
VP and Head of Silicon	VP
Executive Vice President/Treasurer	VP
Business and Organizational Development, Asia Pacific	Other
Group Managing Director & Sr. Vice President	VP
Law & Policy	Other
DATA SCIENTIST	Other
Biotechnology Leadership	Manager
Global Head, Publisher Strategy & Business Development	Director
Holographic Production Srate	Other
Associate Professor of Pediatrics & Medicine	Other
Senior Vice President of Kraft International	VP
Chief of the Cell Biology & Metabolism Branch	C-Suite
Director, HR & Operations	Director
Web Developer & CTO	C-Suite
Director of Educational Initiatives & Training	Director
CRM & MDM Project Manager	Manager
Member of the Board of Directors of China Petrochemical International Co. Ltd.	C-Suite
Co-Founder, Business Development + Growth	C-Suite
Founder-C.E.O.	C-Suite
Executive Vice President, General Counsel And Assistant Secretary	VP
Sr. VP, Strategic Marketing	VP
Client Partner Manager	Manager
Manager - Strategic Planning	Manager
General Manager, Iberia	Manager
CFO @ Foodninja.in	C-Suite
Board of Directors and the Audit committee	C-Suite
Vice President of Broadband TV	VP
Representative and Editor	Other
Director of Technical Affairs	Director
Vice-president of sales for Orange County	VP
Chief Executive, Canada	C-Suite
Partnerships & Business Development	Other
Electrical Design Engineer	Other
Director of R&D, Co-Founder	C-Suite
Social Media, Web Advisor	Other
National Manager, Denmark	Manager
Director – Internal Audit	Director
VP - Civil Affairs - Public Affairs Division - France	VP
Head of Mercedes-Benz	Director
Technology Finance Architect	Other
Co-Founder, E-Commerce	C-Suite
VP Operating Strategy	VP
President of Electrical, Fence & Mechanical	Director
Creative Audio & Radio Producer	Other
Associate Professor in Financial Services and Associate Head of Resourcing and Planning	Director
Founding Principal and Strategic Creative Officer	Other
Co-Founder | President	C-Suite
Head - Fashion	Director
Director, API Banking	Director
Startup Jedi & Mentor	Other
Applications Manager	Manager
CEO | Chief Data Scientist	C-Suite
Led a Disk Drive Development Program	Other
Chief Revenues Officer	C-Suite
Boar Member	C-Suite
Director of Electronic Communications	Director
Director, Enterprise Network Services	Director
Vice President, Search Engine Marketing	VP
Certified Public Accountant and Computer Audit Specialist	Other
President of Texas Group	Director
Honorary president	Director
Director, Finance & Corporate Controller	Director
Softwa Engineer/Lead	Manager
Vice President - Venture Investments	VP
Advisory Board and Management Consultant	Other
Principal & Director of Marketing	Director
VP of US Strategy & Portfolio	VP
Professor in the Department of Biochemistry	Other
Media Investment Banker	Other
Director, U2 Data Servers & Tools	Director
Director, US DX Technical Evangelism	Director
Partner and Team Leader	Manager
Medical Strategist	Other
Director & Principal Research Scientist	Director
Manager of design and marketing	Manager
Web Application Developer - Tencent America	Other
VP Federal Issues, Silicon Valley Leadership Group	VP
VP of Product Management, Consumer Products	VP
Tivoli Acquisition Architect	Other
Head of HR and Managing Director for Applied Materials Israel	Director
Player Support Supervisor	Manager
Board Of Directcors	C-Suite
Associate Dean, School of Medicine, Professor of Medicine, of Genetics, of Biomedical Data Science	Other
Founder & Non-executive director	C-Suite
Senior Director Procurement, Research & Development	Director
VP of Artificial Intelligence R&D	VP
Director, New Media & Strategic Markets	Director
Production Manager for Asea Low Voltage Division	Manager
Associate Advertising Manager	Manager
Head of Product Development & Design	Director
Field Services Manager	Manager
Android Lead Developer	Manager
CEO/Principal	C-Suite
VP of US Clinical Development	VP
VP of Global Support and Services	VP
SVP, Insights	VP
Principal - Head of Security Architecture ASEAN	Director
Director Process Engineering & Product Design	Director
Director of Communications and Social Media	Director
Lead Design and UX	Manager
Manager Sales and Customer Success	Manager
Analyst intern	Other
Co-Founder, CEO, Board of Directors	C-Suite
Senior Manager of Farm Animal Welfare	Manager
Assistant Dean of Biomedical Informatics	Other
Planning Executive	Other
Aanalyst	Other
Co-Founder, Director and Head Dentist	C-Suite
Lead Designer and Co-founder.	C-Suite
Head Internal Audit Group	Director
Incubation Product Manager	Manager
Director of Operations, Information Security	Director
Director, Business Development (EMEA)	Director
Founder, Creator, and Business Owner	C-Suite
Head of Revenue Partnerships (Director)	Director
Head of Data and Insights	Director
Culinary Scientist, Co-Founder and CSO	C-Suite
IoT Senior Consultant	Other
Founder Of DNS Developers	C-Suite
Deputy Head of Back Office	Director
Product and Business Director	Director
Co-Founder and VP Operations	C-Suite
Director, Clinical Operations, Trial Support and Strategic Outsourcing	Director
Project Development and M&A	Other
Chair/CEO-Global Exec A&R	C-Suite
Operating Partner – Energy, Business Development & Finance	Other
CEO & Advisory Board Member	C-Suite
VP, MARKETING	VP
Junior UX Consultant	Other
Global Art Curator	Other
Boad Member (PR)	C-Suite
VP, Marketing and Business Development	VP
Biz Dev Associate	Other
Digital Planning Director	Director
Legal Director and Deputy Executive Director	Director
Fund Accounting Analyst	Other
Senior Sofware Engineer	Other
Vice President Product Management & Strategy	VP
Senior business process consultant	Other
Director of National Sales	Director
Senior Acquisitions Editor	Other
Sr. Demand Generation Strategist	Other
OpenStack Architect	Other
IT-Systems Analyst, Web-Development Specialist	Other
Head of Responsible Investment	Director
Spring Framework Committer	Other
5G Platform Solution Architect	Other
Sr. Technical Marketing Architect - VMware Cloud on AWS	Other
Senior Systems Programmer	Other
SVP, CourtLink Strategy and Planning	VP
President of North America & Senior Vice President of Sales, Marketing and Services	VP
Director & Chief Technology Officer	C-Suite
National Sales Mgr	Manager
SVP, Digital Media and Interactive Entertainment	VP
VP Marketing Products	VP
Google Cloud Developer Advocate	Other
Digital Product Development & Office of Architecture	Other
Technology Investment Banking	Other
CEO Sogeti France, USA & India	C-Suite
Member of the Sub-Advisory Board	C-Suite
President & GM - Venezuela, Trinidad & The Caribbean - Caracas, Venezuela	Director
Partner of Privacy & Data Protection Practice Group	Other
CEO | Digital Strategist	C-Suite
VP Trade Finance	VP
Operational Director, UK	Director
Planning engineer	Other
Engineer, Technology Development - Portland	Other
SVP, Regulatory & Quality	VP
Team Member, Transportation Group Hamilton	Other
Vice President, Business Strategy Group	VP
United Kingdom CEO	C-Suite
Dir. WW Sales	Other
Vice President of Operations, Eastern Region	VP
Client Relations Assistant	Other
Regional Creative Director McCann Central Eastern Europe and Chief Creative Officer	C-Suite
Senior Vice President – Information Technology, Chief Information Officer	VP
Head, Music	Director
Chief Impact Strategist	C-Suite
V.P. of Operations and I.T	VP
Senior Vice President, Manufacturing/Production	VP
Technical Resource Administrator	Other
General Manager of Residential Controls	Manager
CTO, IBM Cloud	C-Suite
Director, Product Management and Marketing	Director
Digital Collaboration Services Director	Director
Director: Buck/Cardinal Board of Directors	Director
In-house Legal Counsel	Other
AI Business Director	Director
Professor of Biology and Physiology	Other
Analyst and Manager, Route Planning	Manager
US Services Program Manager	Manager
Sr. Director - Brand Marketing	Director
EVP of Marketing and Sales	VP
Testing	Other
Project/Marketing Manager	Manager
CTO, Founder at GreenOnyx Ltd.	C-Suite
Digital Acquisitions Manager	Manager
Director of Master Data Management	Director
Design co-founder	C-Suite
Research Vice President	VP
Partner, Head of U.S. Sustainable Growth Fund	Director
Global Digital & Social Media Director	Director
Chairman of the Board - AXA Luxembourg SA	C-Suite
CTO and VP of engineering	VP
Teaching Fellow / Research Fellow	Other
Director of Services US	Director
Deputy Chairman of the Executive Board - RUSNANO Management Company LLC	C-Suite
Consultant, Financial Inclusion Practice	Other
Manager of Quality Assurance and QC	Manager
Global Commerce, Head of Craft and High End Stores	Director
Managing Director, Core Services	Director
Assistant Governor	Other
Co-founder & Biz Dev & Marketing	C-Suite
Group Controller for HP's Software Solutions Organization	Other
VP, IT (Westburne)	VP
Member of the Board of Directors & Co-Chairs of the Taskforce on Measurement	C-Suite
Sr. Director West	Director
Assistant Vice Chancellor for Research	Other
Supplementary Instructor	Other
Graduate Teaching / Research Assistant	Other
Associate Metallurgist	Other
Director, Account Management	Director
Special Needs Health Care Assistant	Other
Director, Datacenter Operations	Director
Co-Founding Editor	C-Suite
Mobile Applications Engineer	Other
Co-Founder & Head of Impact	C-Suite
General / Senior Accountant	Other
Da Nang Branch Director	Director
Faunder	Other
BI & Analytics Director, Strategic Planning	Director
Former President of Armada Oil	Director
Director - Bariatric & GI Surgeon	Director
MI Process & Planning Analyst	Other
EU Head of Marketing & Site Performance	Director
Vice President Exploration and Director	VP
Producer & Account Executive	Other
Director of EMSS BU	Director
Solutions Engineer - EMEA	Other
Head of Operations Europe	Director
Global Franchise Head, Alcon Surgical	Director
Director Digital Television Products	Director
Sr. Solutions Architect	Other
Group Digital Commercial Operations Director	Director
Head - Consumer Operations	Director
Real Estate Manager	Manager
Partner L1 Health	Other
Geology Manager	Manager
SVP Human Resources and Administration	VP
CEO / Co-Founder	C-Suite
Group Finance Controller, Finance Central Functions Directors	Director
Infrastructure Finance Think-Tank	Other
VP of Content, Lifestyle	VP
MD and Head of Strategy	Director
Co-Founder and Partner20	C-Suite
SVP, Mail	VP
Team Leader for Foreign Sales	Manager
CISO/Head of Security and Compliance	Director
Global Lead Security Architect	Manager
CFO & Partner	C-Suite
Founder Circle Member	C-Suite
Technical Advisor - Data Science	Other
Financial Executive and Management Roles	Manager
Head of Mobile, Social and CRM	Director
Copy Advice Executive	Other
Co-Founder, Chief Web Officer	C-Suite
Reception	Other
Head of DuPont’s Asia operations	Director
Director and Chartered Financial Planner	Director
Mobile Technology Development Management	Manager
Director of Marketing and Engagement of Members	Director
SVP & GM of Marketplaces	VP
Founder & Member of the Jury	C-Suite
Professor Computer Science	Other
Director of Publications and Special Projects	Director
CTO of Local Classifieds	C-Suite
Co-Founder, CAO	C-Suite
SaaS Product Manager	Manager
Senior Business Banking Analyst and Industry Specialist	Other
Producer + Founder	C-Suite
Chairman of Board and Managing Director	C-Suite
VP, Retail Analytics	VP
VP, Blockchain Technologies	VP
Vice President of Competitive Technical Intelligence	VP
Vice President, Investment Finance	VP
Senior Cloud Solutions Architect	Other
Product and Bi Director	Director
Senior Developer and Operations Manager	Manager
Ph.D. research	Other
CEO & Co-Founder, Game Designer	C-Suite
P2P Platform Lead	Manager
Chair of Life Sciences & Dean of Undergraduate Research	Other
Enterprise CSM & Team Lead - West	Manager
Director of Finance and Strategy, Global Purchasing	Director
Chief Scientific Officer & President	C-Suite
Vice President of Internet Marketing	VP
HeadHunter	Other
Brand President, Cereality	Director
Technical Director: Midstream & Downstream	Director
Regional VP Belgium (VP Sales and Operations)	VP
VP of Business Development & Co-Founder	C-Suite
Director, Facial Nerve Clinic	Director
Sr. Game Designer	Other
Consumer Products	Other
VP Service Strategy and Marketing	VP
Vice President, Western US	VP
Scientific Advisory Board Member	C-Suite
Head of Web	Director
Investro	Other
Psikolojik Danışman	Other
CTO | Founding Team Member	C-Suite
Managing Partner, Data Center Development	Other
Senior Market Maanger	Other
VP - Team Leader	VP
Band Member	Other
Director of Research	Director
Web & App Development (The Grand Poobah)	Other
VP, West Coast Sales	VP
he was Vice President of Sales	VP
Director Sales, Industrial IoT	Director
IT Systems and Network Director	Director
IT Infrastructure	Other
International Supply Growth	Other
Captain - Deputy Program Manager, Computer Resource Management Technology Program	Manager
Senior Partner and Managing Director New York	Director
Director of Innovation - AI	Director
SVP, Public Business	VP
Systems Engineering Manager EMEAR Cloud Security	Manager
Chief Regulatory Counsel	Other
Director eHealth Innovation	Director
Personnel Assistant	Other
Vice President, New Product Innovations	VP
Head - Enterprise Technology Solutions	Director
Accounting Manager	Manager
CAB Director of Membership & Recruitment	Director
BI Project Manager	Manager
CMO | Chief Marketing Officer	C-Suite
Consulting, Interim and Investment Services	Other
Senior contributor	Other
Usability & User Interface Lab	Other
Head of Product Design and Research and Sr. Director of Product Design	Director
Head of Egineering	Director
V.P. of Sales Conexant	VP
Managing Director, Ecommerce	Director
VP - Microsoft Solutions Practice	VP
Business Humanizer	Other
Software and UX Engineer	Other
Assistant Development Director	Director
Principal | Director of Structural Engineering	Director
Co-Founder & Vice-Chairman	C-Suite
Member of the Scientific and Clinical Advisory Board	C-Suite
Board of Advisor Member	C-Suite
Manager Technical Training	Manager
Professor For Digital CRM	Other
Jefferson E. Peyser Professor of Law	Other
Senior Advisor (of Counsel)	Other
Advisor (Interim Assistant Vice President and Director of Public Safety at The University of Iowa)	VP
EVP, Product Management and Marketing	VP
Protocol Engineer	Other
VP, Brand Marketing and Creative	VP
Israel CEO & Co-Founder	C-Suite
Corporate Attorney / Foley & Lardner Accelerator	Other
GM Facilities	Other
Vice Chairman of GEODIS Supervisory Board	VP
Vice President and Data & Analytics	VP
Principle Technical Marketing Engineer	Other
Head Of Digital UX	Director
Vocational training as communication electrician	Other
Director of Producting Marketing	Director
FD - Europe	Other
General Counsel and Member of the Executive Committee	C-Suite
Tour, PR and Merchandise Manager for Artists	Manager
Sr. Partner Manager	Manager
Investor / Affiliate	Other
CTO | CIO	C-Suite
Head of Wealth Management	Director
Vice President, Systems Engineering	VP
VP, Software	VP
Director HR and Administration	Director
Marketing Principal	Director
HW and FPGA designer	Other
Co-Founder & Chief Shirt Architect	C-Suite
President and CEO of the U.S. and Canadian operations	Director
Vice President of Manufacturing and Vice President of Backend Operations	VP
VP of Products, MongoDB	VP
VP - Marketing	VP
Audit and Accounting	Other
Algorithm Development Intern	Other
Worldwide Leader in Core-Systems	Manager
Director of contracts and finance	Director
Member of the Board of Directors - InDex Diagnostics AB	C-Suite
Mobile Developer (iOS & Android)	Other
Board Member, Treasurer & CFO	C-Suite
Head of China Operations	Director
Manager (Various Roles)	Manager
Head of Sustainable Investments	Director
Chief, Design	C-Suite
Senior Director, SWQA	Director
Director of the Training Center	Director
Executive Vice President and Advisor	VP
Vice President, Technology & Engineering	VP
Science Advisor, Optics	Other
General Manager, East Region	Manager
Architecture Advisory Board	C-Suite
Director & VC Investor	Director
Solution Designer	Other
Chairman / Various roles - Texas Railroad Commission	C-Suite
EMEA IT Director	Director
Vice-President Sales Communication and Training	VP
EVP and General Manager of Ancestry.com	Manager
Associate Founder & Founding Track Chair, Finance & Entrepreneurship	C-Suite
Education and Mentorship Chair	Other
Director/Advisor	Director
Developer Relations Program	Other
ExExecutive Vice President and Chief Financial Officer	VP
Executive Vice President, CFO, General Counsel and Board Member	C-Suite
President and Managing Director (Philippines)	Director
Director Berlin, Specialist for Contemporary Art	Director
Investment Director (from March 2016, before Investment Analyst)	Director
Chief Legal Officer & Executive Vice Present of Human Resources	C-Suite
Co-Founder and Head RTD Labs	C-Suite
Director of State Programs	Director
VP of Products, Chief Strategy Officer	VP
Global Head Affiliates	Director
Director of Sales & Country	Director
Associate Vice Chancellor for Research	Other
Vice President – Sales (North America)	VP
Vice President Online Learning & Continuing Education	VP
Executive Director & Co-Owner	C-Suite
Co-Founder, Board Director, Chairman, CEO	C-Suite
CEO/Creative Director	C-Suite
Lead Electronics Engineer	Manager
Temporary advisor	Other
Vice President, Ops Engineering	VP
Interim Controller	Other
Director of Operations & Logistics	Director
Head of Talent Management	Director
Director, Advanced Product and Technology	Director
Led Various Product Design and Development Projects	Other
President of Customer Segments, Cigna's National Accounts	Director
Partner Marketing Manager	Manager
Educational Technologies Coordinator	Other
Executive Vice President/ General Counsel	VP
Vice President & General Manager GeneInsight	VP
Head of Experiences - Creative Director	Director
Founder / Marketing & Creative Director	C-Suite
Primate Handler	Other
Senior Vice President, Products Division	VP
Senior Vice President of Corporate Strategy & Policy	VP
Startup Mentor	Other
Head Of Human Resources & Administration	Director
Vice-President of Trading	VP
Chief Product and Marketing Officer (CPO & CMO)	C-Suite
Managing Director, Buyouts	Director
Supply Chain and Procurement Executive	Other
Chief Executive Officer and Finance Director	C-Suite
Senior Fellow and Co-Founder	C-Suite
Special Advisor to Chief Executive Officer	C-Suite
IBL Work Placement	Other
Director - CTO Group	Director
EVP, Chief Content Officer	VP
CEO, North America/APAC	C-Suite
UI/UX Designer	Other
Managing Director at IOMEDIA	Director
Public Safety Training Director	Director
Co-founder, Director	C-Suite
Executive Director, Head of Business Insights	Director
Head - Replacement Business Unit	Director
Digital Marketing Team Lead & Strategies Planner	Manager
VP of Strategy and Business Development	VP
VP Store Technology	VP
Vice President of Product and Systems Engineering	VP
Business Development Manager of New Technologies	Manager
Co-Founder & Head of Engineering and Research	C-Suite
Executive Vice President of Operations and Engineering	VP
Network Security Researcher	Other
Director Computer Vision	Director
Service Information Director	Director
VP, regulatory affairs and program management	VP
President of Government programs	Director
Chief Mentorship Officer	Other
VP, International Business Dev	VP
Honorary Professor of Medicine	Other
Vice President of Central Engineering and Enterprise Management for SunGard Global Services	VP
Director of Search Engine Watch	Director
Senior Account Executive / Regional Marketing Manager	Manager
Senior Director, Software Engineering	Director
Mentor at The Entrepreneurial Incubator	Other
Principal Infrastructure Engineer	Other
User Experience & Visual Design Lead	Manager
Head of Stockholm Data Parks	Director
Managing Director & Global Head of Banking Channels Technology	Director
VP finance and innovation	VP
Integrated Researcher	Other
Chief Technology Officer, Ensemble	C-Suite
COO- ICQ	C-Suite
Head of Real World Intelligence	Director
SVP & Executive GM - Mobile Network Operations Unit	VP
SVP - General Counsel	VP
CoFounder & Director of Content	Director
Head - Content and branding	Director
Founder and Head Chocolatier	C-Suite
Hardware Mentor in Residence	Other
cd genomics	Other
Starting Work	Other
CRO & Head of Product	Director
Founding Partner & CTO	C-Suite
Founder & Managing partner	C-Suite
President / Founder - National Geographic Kids Entertainment	C-Suite
Chief Technology Officer & Executive Vice President	C-Suite
Founder & Digital Content Strategist	C-Suite
IT & Sales Planning Team Assistant	Other
Co-founder, director of research & development of monitoring and security products.	C-Suite
Senior Manager and AI Expert	Manager
Executive Vice President, Product Development Services	VP
Founding Partner & COO in Indonesia	C-Suite
Microfinance Industry Relations Officer	Other
IP and Patent Advisor	Other
Professor's assistant, Corporate Finance	Other
Conversion Strategist	Other
Vice President, Health, Safety and Security	VP
CEO, Americas	C-Suite
CMO at Telenor, Global Wholesale	Other
Vice President, Cloud and Managed Services Solutions	VP
Summer Undergraduate Research Fellow	Other
Senior Growth & Innovation Consultant	Other
Head of Media and Digital, AMAP Region	Director
CTO and EVP of Engineering	VP
HR, Training & Organizational Development	Other
Head of Analysis, Extraction and Purification	Director
Global Delivery Head / CTO	C-Suite
Principal, Deputy Chief Compliance Officer	C-Suite
Mobile Product Marketing Mgr, Small Business	Other
Board of Directors & Advisory Board	C-Suite
Managing Director and Segment Head	Director
CEO, Project Lider	C-Suite
Founder, CSO, Director	C-Suite
Director Network Research Product Management	Director
Innovation & Imagineering Consultant / Co-founder	C-Suite
Collateral Examiner	Other
President/Founder/ COO	C-Suite
Account Manager / Project Manager	Manager
Vice President, Strategy and External Relations	VP
Senior analyst, Principal	Other
Director of Marketing & Content	Director
Full Stack Software Developer (Java & ReactJS)	Other
Team Lead & iOS Developer	Manager
Assistant Professor, Urologic Oncology, Department of Urology	Other
Associate Director of Innovation Investment	Director
Digital Investment Director	Director
Startup Camp Director	Director
Investment BAnking summer Analyst	Other
Executive Director of Automotive Grade Linux	Director
Managing Director, joiz Switzerland	Director
Head of US Business Development	Director
Shareholder, CFO	C-Suite
Start-up Junkie, former Head of Products at Lexity Labs (acquired by Yahoo)	Director
QuickTime	Other
Founder - Product first Engineer	C-Suite
Chief Ambassador	C-Suite
Chief Economist of Morgan Stanley MUFG Securities	C-Suite
Member Services Coordinator	Other
Chairman & Co CEO	C-Suite
Group Chief Executive of Communications, Media & Technology	C-Suite
EVP, General Counsel & Corporate Secretary	VP
Assistant Vice President, ETFs, Indices & Dividends	VP
Development Fellow	Other
Equippo Founder and CEO	C-Suite
EVP, Chief Information Officer & Chief Security Officer	C-Suite
Founder; SVP Strategy and Business Development	VP
Executive Vice President, CEO	VP
Customer Relation Management	Other
Showroom Manager	Manager
Strategy V.P. & MENA Sales	VP
Founding boardmember	C-Suite
Head of Brand and Consumer Engagement	Director
Process Technology, Transfer, and Development Manager	Manager
Director of Organic Marketing	Director
Vice President of Operations — Provider Data Management	VP
Chief Technology Officer & Co Founder	C-Suite
Director,Information Security and Risk Management	Director
President of National Security Solutions	Director
SVP, News	VP
Staff Technical Support Engineer	Other
Chief Research and Development Director	Director
Research Manager, Digital Transformation	Manager
Research Aerospace Engineer	Other
Sr. Engineer and Manager	Manager
Investment Banking Intern, Financial Sponsors Group	Other
Positions of Senior Director, Global Risk Operations	Director
Business Development, Director	Director
Senior Director, Salesforce, CRM, CPQ	Director
VP, Business Development (consultant)	VP
Lead Strategy Consultant	Manager
Sr. Alliance Manager,Cisco WebEx	Manager
Manager Chandra X-Ray Telescope Software	Manager
VP Channel Development	VP
Branch Sales Manager (Karamoja)	Manager
Early Stage Researcher	Other
Manager, International Projects	Manager
Lead Visual Effects Artist	Manager
Director of Growth & Communications	Director
SVP and Senior GM	VP
financial/real estate advisory sector	Other
Vice President of Solutions Engineering and Marketing for Enterprise Business Services	VP
Director of Software/Founding Member	Director
Vice President of Digital Strategy	VP
Vice Chairman and Partner	C-Suite
Lead UX and Designer	Manager
Lead - Potential Fields Technology	Manager
Editor SF Bay Area	Other
Executive Director, Cloud Practice	Director
Lead Analyst for the Targeted Sharing Program	Manager
Senior VP - Operations	VP
International Engagement	Other
Operations/HR Manager	Manager
Co-Founder and Senior Managing Principal	C-Suite
Director of Data Services & Engineering	Director
Executive Vice President of Worldwide P&C Claim	VP
Head of People, Culture & Brand	Director
Chief, Legal Affairs & Trade Policy	C-Suite
founder&ceo	C-Suite
Senior Vice President, VWR Services	VP
VP of Marketing Sales	VP
Vp of Northeast Sales	VP
Co-founder, Technical Lead	C-Suite
VP, Director of Content	Director
Director of Global Sourcing & Licensing	Director
VP, Brands	VP
VP & GM - Discrete Semiconductors	VP
past-CEO	C-Suite
Director Operations & Services	Director
Business Development Volunteer (BEAD)	Other
VP Clinical	VP
Global Communications Manager	Manager
Deputy Assistant Administrator for Research & Development	Other
Director of Hackathon	Director
Managed Regulatory, Quality and Clinical Strategies	Other
Co-founder, CIO & JMD	C-Suite
Director, Outreach & Quality	Director
Digital Marketing & SEO Director	Director
Director of Global Alliances	Director
San Francisco Manager for Architectural Digest	Manager
Managing Director,General Partner	Director
President, Advisory Board	C-Suite
Director, Marketing Operations	Director
Co-Founder/Chief Wellness Officer	C-Suite
International Management Level	Other
GM - Substation Division	Other
Founder and Chairman of the Board of Directors ,CEO	C-Suite
Group Vice President Grocery Products	VP
Editorial Leadership Roles	Other
Director of E-Health	Director
Enterprise Risk Consultant	Other
Director of Completions and Reservoir Engineering	Director
Executive/Consultant	Other
Cadete administrativo	Other
CFO & EVP of Operations	VP
Executive B2B & Marketing Coordinator	Other
Global Head, Research	Director
Capital Markets Southeast Europe	Other
Chairman, Member of the board	C-Suite
Consulting Associate Professor of Medicine	Other
Digital Marketer & Co-Founder	C-Suite
Owner, Dentist	Other
Epidemiologist	Other
Customer Care Associate	Other
Head of SaaS Operations	Director
Digital Marketing & Web Analyst	Other
MD - Insurance	Other
Product Manager Climate Comfort @ Behr	Manager
President Turner Pictures and Executive Vice President TNT	VP
Sr. Director, IoT GTM	Director
Chief Projects	C-Suite
Founder, Chief Technical Officer, Chief Operating Officer	C-Suite
Co-Founder, VP - Finance	C-Suite
Chief Executive Officer RealBiz Media	C-Suite
Product Manager, Sales Engineer	Manager
Researcher and Partner	Other
Chief Advocate for Business Growth	C-Suite
Head of Digital Marketing and Brand Strategy	Director
Software Consultant -China Research Lab	Other
